灵水	spiritual water
游小默	You XiaoMo
灵水	spiritual water
丹	pill
灵草	magic herb
乔无星	Qiao WuXing
天心	Tian Xin
颜辉	Yan Hui
程向荣	Cheng XiangRong
驭兽	Beast Transfiguration
无星	WuXing
无双	WuShuang
蛇球	SheQiu
熊笑	Xiong Xiao
凌霄	Ling Xiao
吞金兽	Metal Swallowing Beast
独眼刀疤	One-Eyed Scarface
小黑	XiaoHei
灵魂之力	soul force
灵气	spiritual energy
丹师	mage
皮球	PiQiu
毛球	MaoQiu
猫球	CatQiu
蛇球	SheQiu
玉简	jade drive
游安泰	You AnTai
段奇天	Duan QiTian
于步	Yu Bu
通天大陆	TongTian Continent
安桥	An Qiao
空间符	teleportation talisman
灵晶	spirit gem
丹师工会	Mage Association
驭兽工会	Beast Transfiguration Guild
闭关	secluded cultivation 
本命契约	lifebound contract
晋级	advance
识海	sea of consciousness
人境	Man Realm
地境	Earth Realm
天境	Sky Realm
日境	Sun Realm
月境	Moon Realm
星境	Star Realm
辰境	Celestial Realm
灵境	Spiritual Realm
皇境	Imperial Realm
帝境	Emperor Realm
神境	Divine Realm
圣境	Sacred Realm
妖凰族	Demon Phoenix Clan
姬凤	Ji Feng
麒麟族	Qilin Clan
太白	Tai Bai
苍盟盟主	Head of the Cang Alliance
方迟尧	Fang ChiYao
修炼者	practitioner
师侄	Martial Niece
臭老头	Shitty old geezer
老家伙	Old fart
强者	expert
秦大哥	Big Brother Qin
游兄弟	Fellow/Fellow Brother You
灵气	spiritual energy
灵草	magic herb
炼丹	Refine pills/magic pills
灵魂之力	soul power/ power of the soul
修炼者	practitioner
淬炼	Distill herb/magic herb
丹师	Mage
功法	Soul training
技法	Skill training
巩固	consolidate
境界 	realm
灵魂技法	Skill training manual
中阶下品的灵魂技法	low-grade middle level skill manual
六级上品丹师 	high-grade level six mage
高阶中品功法 	high level 'mid-grade soul training manual'
低阶上品技法 	high-grade low level skill training manual
高阶上品 	high-grade high level manual
几株	a few stalks
六十副	60 sets
储物袋里	magic bag
天魂经	Heavenly Soul Scripture
传送阵	Transport circle
玉简	Jade drive
水晶石 	crystal orbs
金冥鼎 	Jin Ming Cauldron
图集	encyclopedia
清心丹	mental purification pill
黄沙丹	Golden Sands pill
天灵丹 	TianLing pill 
固元丹 	GuYuan pills
生骨丹	Bone Growth Pill
活血丹	Blood Circulation Pill
容颜丹	Beauty Pill
凤凰丹 	Phoenix Pill
还命丹 	Revival Pill
玉髓丹	Chalcedony Pill 
乙级学区	Ward B
三班	Class Three
丹师公会	Mage Association
一区	Block 1
二区	Block 2
学区	Ward
销售点	Sales area
黑印村	Hei Yin Village
天堂境	Paradise Realm/ Heavenly Paradise
技阁	Skills Pavilion
功法阁	Soul Training Pavilion 
技法阁	Skill Training Pavilion
赛区	competition zone/venue/division
修为不高	level/cultivation base  was not that high
默默地抹掉一脸血	silently wiped the blood off his face
超友谊	super close
小黄瓜	balls testicles
自作多情	showering affection on an uninterested party
心中的想法	Inner thoughts
炙手可热	hot topic
面色不善	eyed him with distaste
xx 家	xx Family/Clan
五大势力	Five Great Powers
刀门	Dao sect
炎帮	Yan group
四大家族	Four Big Clans
学院八大巨头	DaoXin Academy's Eight Giants
点数	Point
等級	level
晉級 	gained a level
能量罩笼	Energy shield
淡淡的能量薄膜	thin layer of energy film 
晶点	Luminous fragments
步骤	Process/steps
融合	Refining
百人榜	Top hundred ranks/rankings
纠缠不清	pester/harass/hound
晋级	advance
识海	sea of consciousness
高级位面	Higher Level Realm
中级位面	Middle Level Realm
帝王兽	Emperor Beast
无尽之海	Boundless Sea
灵脉	leyline
化形草	Shapeshifting Herb
元素之心	Elemental Essence
血脉	bloodline
本命契约	lifebound contract
琉璃水蛟	Azure Sea Dragon
闭关	secluded cultivation 
甲级学区	Ward A
破风声	whistling through the air
本命火焰	Lifebound Natal Flame
精血 	Life Blood
空间传送	Dimensional Teleportation
苍盟	Cang Alliance
四灵帝王兽	Four Divine Emperor Beasts
游震天	You ZhenTian
展雨轩	Zhan YuXuan
风迟云	Feng ChiYun
银戈	Yin Ge
麟昊武	Lin HaoWu
灵丹	magic pill
绵绵山	Amaranthine Mountain
传音石	transmission stone
金翅虫	Golden Winged Insect
傅苍穹	Fu CangQiong
唐中华	Tang ZhongHua
星罗城	Xing Luo City
城主	City Master
小乒	Xiao Ping
小乓	Xiao Pang
轮回丹	Samsara Pill
储物袋	magic bag
领域	domain
花姑	Hua Gu
金龙	Golden Dragon
远古妖凰	Ancient Demon Phoenix
五彩之鸟	Five-Colored Bird
九夜	Jiu Ye
南陆	South Continent
麒麟神火	Qilin Godfire
大鹏鸟	Giant Roc
程荷	Cheng He
彩丹	rainbow pill
丹方	pill recipe
乾坤丹	Cosmos Pill
拂柳幽典	Buddha’s Willow Standard
精血	Blood Essence
龙族	Dragon Clan
修炼所	Cultivation Institute
巨无霸	Giganticus
武成	Wu Cheng
武正	Wu Zheng
传族之宝	Inheritance Jewel
鬼哭涯	Weeping Ghost Shore
麟古	Lin Gu
逍遥院	XiaoYao Institution
游君其	You JunQi
妖凰神火	Demon Phoenix Godfire
灵识	intelligence
邢七	Xing Qi
通灵玄龟	Psychic Black Turtle
玄龟族	Black Turtle Clan
旁支	side branch
莫景	Mo Jing
神通	Spiritual Sense
妖兽	demon beast
传送	transported
大哥	dage
少年	young man
同伴	comrade
中天	Zhong Tian
中心城	Central City
西境	Xi Jing
高殷	Gao Yan
十二阶	Level Twelve
十一阶	Level Eleven
拱手	obeisance
拱起手	obeisance
灵龟族	Mystic Tortoise Clan
玄明	Xuan Ming
小乌龟	baby turtle
白骨小镇	White Bone Town
客栈	inn
鬼哭涯	Weeping Ghost Shore
鬼冢山脉	Ghost Tomb Mountain Range
远古战场	Ancient Battlefield
走火入魔	Qi deviation
丹青	Dan Qing
修炼	cultivating
龙翔大陆	Long Xiang Continent
古叔	Uncle Gu
鬼哭崖	Weeping Ghost Shore
天恨	Tian Hen
天明	Tian Ming
巅峰	pinnacle
天元	Tian Yuan
天门	Tian Men
彩级一品	Grade One Rainbow Level
炼丹房	Pill Refining Room
自在阁	Leisure Pavilion
赤血家族	Vermillion Blood Clan
胡村	Hu Village
天公鼎	Heavenly Cauldron
杂质	impurities
天修	Tian Xiu
天刀	Tian Dao
禁制	Restriction 
禁地	Forbidden zone
游族	You Family
旁枝	side family
大神通者	powerhouse
顶级灵草	transcendent level magic herbs
顶级	transcendent level
品质	quality
提炼	extracting
笑阁	Smile Pavilion
头儿	Leader
精血	Life Blood
位面空间	planes of dimension
血玉	Blood Jade
传音石	transmitter stone
妖坟场	Demon Beast Graveyard
乒乓	Ping Pang
四灵	Four Ancient Beast Clan
中品	mid-grade
活水河界	Living Waters River Boundary
龟族	Tortoise Clan
篮球	LanQiu
天狗	TianGou
天鬼	Tian Gui
黑熊	Hei Xiong
老板娘	proprietress
自然城	ZiRan City
玄盛	Xuan Sheng
刍云山脉	ChuYun Mountain Range
玄泽	Xuan Ze
王华	Wang Hua
杨丁	Yang Ding
赵二	Zhao Er
万厨师	Chef Wan
助手	assistant 
海初	Hai Chu
玄宗	Xuan Zong
修为	cultivation base
低级灵草	low level magic herb
刑七	Xun Qi
刑七	Xing Qi
一刻钟	fifteen minutes
死亡之森	Forest of Death
内丹	Life Crystal
契约兽	contracted demon beast
交易所	Exchange Quarter
乌梅镇	Ebony Plum Town
三区	Block 3
黑蜘蛛	Black Spider
黑鸦	Black Crow
叶农	Ye Nong
双鱼酒楼	ShuangYu Hotel
儿纸	Sonny
乔无双	Qiao WuShuang
冥想室	Meditation Room
七罪兽	Seven Sins Beasts
贪狼	Wolf of Greed
姬云琅	Ji YunLang
姬文	Ji Wen
姬武	Ji Wu
中庭交易会	Zhong Ting Trade Fair
姬凤	Ji Feng
卫白	Wei Bai
姬芮	Ji Rui
姬宁禹	Ji NingYu
银夫人	Lady Yin
游明	You Ming
碧妖蛇	Jade Devil Snake
东洲	Dong Zhou
古玛部落	Guma Tribe
真龙族	True Dragon Clan
麟天	Lin Tian
通天殿	TongTian Palace
拍卖师	auctioneer
灵酒	spirit wine
转生丹	Reincarnation Pill
游丹青	You DanQing
红鹰炉	Red Eagle Cauldron
晶石板	Crystal Tablet
酒师	sommelier
一品彩丹	grade one rainbow pill
二品彩丹	grade two rainbow pill
上品灵草	high-grade magic herb
中级灵草	mid-grade magic herb
鲸岛	Whale Island
炉鼎	cauldron
荒蛮位面	wild plane
灵力	spiritual energy
空间戒指	dimension ring
芥子空间	pocket dimension
龙傲	Long Ao
江流	Jiang Liu
龙太白	Long TaiBai
姬赫	Ji He
玄正	Xuan Zheng
游柏	You Bo
集九镇	JiJiu Town
好来客栈	HaoLai Inn
集九镇	JiJiu Town
好来客栈	HaoLai Inn
掌柜	shopkeeper
阿川	A Chuan
灵智	Intelligence
苏郎	Su Lang
万灵地羊	Thousand Spirit Earth Sheep
乌山集镇	WuShan Town
苏朗	Su Lang
彩级二品	Grade Two Rainbow Level
灵草堂	Magic Herb Shop
百鸟谷	Hundred Birds Valley
姬翁	Ji Weng
混球	HunQiu
谢俊	Xie Jun
莫雪	Mo Xue
牛徐阳	Niu XuYang
莫菲	Mo Fei
心灵花草	Heart Flower Herb
圣女	holy maiden
彩级六品	Grade Six Rainbow Level
彩级五品	Grade Five Rainbow Level
洞域	Dong Yu
莫非	Mo Fei
夏玛	Mo Ma
夏音	Xia Yin
莫玛	Mo Ma
罗闻宗	Luo WenZong
洞域强盗	Dong Yu Bandits
超级洞府	legendary cave dwelling 
黑色大峡谷	Black Canyon
洞城强盗	Dong Yu Bandits
阵法	array
幻阵	illusion array
水西部落	ShuiXi Tribe
白虎	White Tiger
万俟西元	MoQi XiYuan
独立空间	independent dimension
玄龟	Black Tortoise
伏子林	Fu ZiLin
红冠鸡	Red-Crowned Turkey
心脉丹	Heart Meridian Pill
叫花鸡	Beggar's Chicken
鼠兽	Rat Beast
黄鼠兽	Weasel Beast
适应期	adjustment period
叫化鸡	Beggar's Chicken
空间之力	spacial energy
玉片	jade token
万俟荣	MoQi Rong
水妖	Water Demon
琉璃手	Azure Palm 
散修	lone practitioner
八府	Eight Mansions
麟少逸	Lin ShaoYi
丹师大会	Mage Assemblage
桃源遗迹	Peach Blossom Ruins
桃园遗迹	Peach Blossom Ruins
第六府	sixth mansion
结界	barrier
灵山	Spirit Mountain
灵山八府	Eight Mansions of the Spirit Mountain
洞府	Immortal’s Cave
桃源灵山	Peach Blossom Spirit Mountain
奇门遁甲	Qimen Dunjia
瘴气	miasma
三大凶门	'three bad luck doors'
浴火宝丹	Fire Baptism Pill
上品	high grade
下品	lower grade
邪物	evil spirit
真龙之息	The Breathe of the True Dragon
神火	Godfire
龙息	Dragon's Breath
寒潭	cold lake
晶石	spirit stone
天梯	heavenly stairs
游齐北	You QiBei
二师兄	second-shixiong
须印	Xu Seal
须弥印	Sumeru Seal
万沙部落	WanSha Tribe
傅盟主	Alliance Head Fu
黑蛇狂舞	Black Snakes' Frenzy
小三	Xiao San
蓬莱书馆	PengLai Bookstore
龙越	Long Yue
张澜宇	Zhang LanYu
婉雅	Wan Ya
何东	He Dong
通天帝	TongTian Emperor
白袍人	white-robed 
复灵丹	Spiritual-Replenishing Pill
绝灵阵	spirit-locking circle
噬铁兽	Iron Devouring Beast
时光壁	Time Wall
阵眼	core
阵	array
绝杀阵	Absolute Death Array
夜明珠	Night Pearl
姬素心	Ji SuXin
方宸乐	Fang ChenLe
大师兄	Da-shixiong
赵达舟	Zhao DaZhou
道心学院	Dao Xin Academy
祖玛	Zu Ma
五福灵眼	Five Blessing Spirit Eye
小师弟	Xiao-shidi
灵眼	Spirit Eye
方阳	Fang Yang
万通	Wan Tong
极品灵眼	transcendent level Spirit Eye
宗祠	Ancestral Shrine
灵犀	Resonance Bullet
麒麟主	Qilin Lord
参龙草	Dragon Ginseng Grass
程义	Cheng Yi
柯于明	Ke YuMing
空间裂缝	spacial crack 
天易	Tian Yi
品水	Grade Water
玉露丹	Jade Dew Pill
姚森	Yao Sen
姚林	Yao Lin
游权	You Quan
麟暝	Lin Ming
游千	You Qian
盗云	Dao Yun
盗神	Thief God
寒公	Han Gong
黑袅	Hei Niao
玉玲珑石	Exquisite Jade Stone
银烈	Yin Lie
左焱	Zuo Yan
至尊者	the Almighty
返神丹	God Return Pill
麟瞑	Lin Ming
姬秀心	Ji XiuXin
东程天	Dong ChengTian
刁雄	Diao Xiong
陶温良	Tao WenLiang
丘冉	Qiu Ran
